息税前利润率	息税前利润率	ebit margin
ebit增长率	ebit增长率
ev/ebitda	ev/ebitda	企业价值倍数
保值增值能力	保值增值能力
报告期负债总额	报告期负债总额
报告期利润率	报告期利润率
报告期营收	报告期营收
报告期资产总额	报告期资产总额
本金	本金
本金回报率	本金回报率
本息保障倍数	本息保障倍数
本益比	本益比
拨备覆盖率	拨备充足率	拨备覆盖率
拨备前利润	拨备前利润
拨贷比	拨贷比	拨贷率
补贴收入	补贴收入
不良贷款拨备覆盖率	不良贷款拨备覆盖率
不良贷款率	不良贷款率
不良净生成率	不良净生成率
不良率	不良率
不良生成率	不良生成率
财务比率	财务比率
财务成本	财务成本
财务费用	财务费	财务费用
财务费用比率	财务费用比率
财务费用率	财务费用率
财务杠杆比率	财务杠杆比率
财务杠杆率	财务杠杆率
财务杠杆效应	财务杠杆效应
产能利用率	产能利用率
产值利润率	产值利润率
偿付能力	偿付能力
偿债能力	偿债能力
偿债能力比率	偿债能力比率
超利润激励	超利润激励
成本	成本
成本比重	成本比重
成本费用	costs and expenses	成本费用	成本费用率
成本费用比率	成本费用比率
成本费用利润率	成本费用利润率
成本费用总计	成本费用总额	成本费用总计
成本贡献率	成本贡献率
成本控制率	成本控制率
成本利润率	成本利润率
成本率	成本毛利率	成本率
成本收入比	成本收入比
成本优势	成本优势
成长能力	成长能力
筹资活动现金流	筹资活动现金流	筹资现金流
筹资现金净流入	筹资现金净流入
筹资现金流量	筹资现金流量	筹资活动现金流量
筹资现金流量净额	筹资现金流量净额	筹资活动现金流量净额	筹资活动产生的现金流量净额
筹资性现金流	筹资活动现金净流	筹资性现金流	筹资活动现金
出资比例	出资比例
出资金额	出资金额
纯收益率	纯收益率
存货	存货
存货净额	存货净额
存货占营业收入比率	存货占营业收入比率
存货周转率	库存周转快慢程度	存货周转率	库存周转率	ito
存款	存款
存款成本率	存款成本率
存款增长率	存款增长率
存款总额	存款总额
贷款	贷款	贷款金额
贷款减值损失	贷款减值损失
贷款减值准备	贷款减值准备
贷款净额	贷款净额
贷款收益率	贷款收益率
贷款同比增速	贷款同比增速
贷款余额	贷款余额
贷款总额	贷款总额
电动化率	电动化率
动态市盈率	动态市盈率
短期偿债能力比率	短期偿债能力比率
短期负债	短期负债
短期借款	短期借款
短期借款比率	短期借款比率
短期债务	短期债务
短期债务比率	短期债务比率
额度利润	额度利润
非经营收益	非经营收益
非流动负债	非流动负债
非流动负债合计	非流动负债合计
非流动资产	非流动资产合计	非流动资产
非流动资产比率	非流动资产比率
非现金支出	非现金支出
非信贷减值	非信贷减值
费用	费用
费用率	费用率
费用率预测	费用率预测
分红率	分红率	分红比率
分红收益	分红收益
分红收益率	分红收益率
分红指标	分红指标
辅料占成本比例	辅料占成本比例
付款周期	付款周期
付息负债成本率	付息负债成本率
付息率	付息率
负债	负债
负债变化	负债变化
负债偿还能力	负债偿还能力
负债合计	负债合计
负债和股东权益	负债和股东权益
负债和股东权益合计	负债和股东权益合计
负债结构	负债结构
负债权益比	负债权益比	产权比率
负债与股东权益比例	负债与股东权益比例
负债与股东权益总额	负债与股东权益总额	负债和所有者权益总额
负债与净资产比率	负债与净资产比率
负债周转天数	负债周转率	负债周转天数	负债合计周转率
负债总额	总债务	负债总额
公允价值变动收益	公允价值变动收益
公允价值变动损益	公允价值变动损益	公允价值变动损失
估值	估值
估值倍数	估值倍数
估值比率	估值比率
估值指标	估值指标
股本	股本
股本净值	股本净值	股份资本
股本盈利率	股本收益率	股本盈利率
股本总额	股本总数	股本总额
股东净资产	股东净资产
股东权益	净资产值	股东权益	公司资本	所有者权益
股东权益比率	股东权益比率
股东权益合计	股东权益合计
股东权益收益率	股东权益收益率	股东权益回报率
股东权益总额	股东权益总额
股份转让价格	股份转让价格
股价	股票价格	股价
股价区间	股价区间
股价涨跌幅	股价跌幅	股价涨幅	股价涨跌幅
股价走势	股价走势
股利支付率	股利支付率	股息发放率
股票评级	股票评级
股票收益率	股票收益率
股票指数	股票价格指数	股票指数
股权	股权
股权回报率	股权回报率
股权结构	股权结构
股权募资	股权募资
股权投资收益率	股权投资收益率
股息	股息
股息比率	股息比率
股息分配率	股息分配率
股息回报	股息回报
股息率	股息率
股息收入	净息收入	股息收入
股息收益率	股息收益率	dy
股息支出	股息支出
股息支付率	股息支付率
固定资产	固定资产
固定资产比率	固定资产比率
固定资产合计	固定资产合计
固定资产投资	固定资产投资
固定资产投资额	固定资产投资额
固定资产投资率	固定资产投资率
固定资产周转率	固定资产利用率	固定资产周转率
固定资产周转天数	固定资产周转天数
管理费用	管理费用
管理费用率	管理费用率
归母净利润	归属母公司股东净利润	归母净利	归属母公司净利润	归属于母公司所有者的净利润	归母净利润
归母净利润率	归母净利润率
归母净利润增长	归母净利润增长
归母净利润增长率	归母净利润增长率
归属母公司股东权益	归属于母公司股东权益	归属母公司股东权益
归属于股东的权益	归属于股东的权益
合同负债	合同负债
核心一级资本充足率	核心一级资本充足率
会计年度	会计年度
活动现金流	活动现金流
活期存款余额	活期存款余额
货币资金	货币资金
获利能力	获利能力
基本每股收益	归属母公司普通股股东净利润	基本每股收益
计息负债	计息负债
计息负债成本率	计息负债成本率
价格	价格
价格区间	价格区间
价格收益率	价格收益率
价值	价值
价值回报率	价值加权回报率	价值回报率
价值增长率	价值增长率
价值增值率	价值增值率
交易性金融负债	交易性金融负债
交易性金融资产	交易性金融资产
接受捐赠收入	接受捐赠收入
借款	借款
借款利率	借款利率
经济价值增长率	经济价值增长率
经济价值增值	经济价值增值
经营成本率	经营成本率
经营活动现金	经营现金流净额	经营活动现金
经营活动现金流	经营活动现金流
经营活动现金流净额与净利润	经营活动现金流净额与净利润
经营利润	营业利润	经营利润	销售利润
经营利润率	营业利润率	销售利润率	经营利润率
经营收入	经营收入
经营现金净流入	经营活动净现金流	经营活动现金流净流入	经营现金净流入
经营现金流	经营现金流
经营现金流量	经营现金流量	经营活动现金流量
经营活动现金流量比率	经营活动现金流量比率	经营性现金流量比率
经营现金流量净额	经营活动产生的现金流量净额	经营净现金流量	经营现金流量净额	经营活动净现金流量	经营活动现金流量净额
经营现金流入净额	经营现金流入净额
经营性现金流	经营活动现金净流	经营性现金流
经营性资产收益率	经营性资产收益率
经营资产	经营资产
净负债	净负债	净负债/净资产	净负债/股东权益
净负债率	债务股权比率	净负债率
净利差	净利差
净利率	净利率	净利润率
净利润	净利润	归属母公司的净利润	归属上市公司股东的净利润	归母净利润	归属母公司股东的净利润
净利润率	净利润率
净利润同比增长率	净利润同比增长率
净利润增长率	净利润增长率
净流动资产	净流动资产
净收入	手续费净收入	净收入	净利息收入
净收益	净收益
净手续费收入	净手续费收入
净息差	净息差	nim
净现金流	净现金流
净现金流量增长率	净现金流量增长率
净现金流入	净现金流入	净现金流入流出
净现值	净现值
净营收收入	净营收收入
净营收增长率	净营收增长率
净营运资本	净营运资本
净增长	净增长
净值	净值	折余价值
净值比率	净值比率
净资产额	净资产额	净资产总额
净资产利润率	净资产利润率
净资产收益	roe	净资产收益
净资产收益率	股东权益报酬率	roe	净值报酬率	权益净利率	股本回报率	净资产收益率
净资产增长率	净资产增长率
绝对涨幅	绝对涨幅
扣非净利润	扣除非经营损益净利润	扣除非经常损益净利润	eve净利润	扣除非经营性损益净利润	扣除非经营性损益的净利润	扣除非经常性损益的净利润	扣除非经常性损益净利润	扣非净利润
累计营收增速	累计营收增速
利率	利率
利润	利润	利润表
利润分配	利润分配
利润率	利润率	profit rate
利润同比增速	利润同比增速
利润增长率	利润增长率
利润总额	总利润	利润总额
利息保障倍数	利息保障倍数
利息成本率	利息成本率
利息费用	利息费用
利息覆盖率	利息覆盖率
利息净收入	利息净收入增速	利息净收入
利息收入	利息收入
利息收入净额	利息收入净额
利息支出	利息支出
联营企业收益	联营企业收益
留存收益	留存收益
流动比率	流动资产与流动负债比率	流动比率	current ratio
流动负债	流动负债
流动负债合计	流动负债总计	流动负债合计
流动性能力	流动性能力
流动资产	流动资产
流动资产合计	流动资产总计	流动资产合计
流动资金增量	流动资金增量
流通股本	流通股本
流通股比例	股票流通比例	流通股比例
流通市值	流通市值
买入	买入
毛利率	毛利率	毛利润率
毛利率预测	毛利率预测
毛利润	毛利润
毛收入	毛收入	总收入
毛收益率	毛收益率
每股股利	每股股利
每股股息	每股股息
每股红利	每股红利
每股经营现金净流	每股经营现金净流
每股经营性现金流净额	每股经营性现金流净额
每股净资产	每股净资产
每股净资产收益	每股净资产收益
每股收益	每股税后利润	eps	基本每股收益	每股盈余	每股收益	每股盈利
每股有形资产	每股有形资产
每股帐面价值	bvps	每股帐面价值
每股指标	每股指标
目标价	目标价
纳税额	纳税额
内部收益率	内部收益率
年度净利润	年度净利润
年度利润	年利润	本年利润	年度利润
评估值	评估值
评级定义	评级定义
普通股	普通股
普通股股东权益	普通股股东权益
期间费用率	期间费用率
期末现金余额	期末现金余额
期权	期权
期望净利	期望净利
其他成本	其他成本
其他筹资现金	其他筹资现金
其他非经营损益	其他非经营损益
其他非流动负债	其他非流动负债
其他非流动资产	其他非流动资产
其他费用	其他费用
其他负债	其他负债
其他经营损益	其他经营损益
其他经营现金	其他经营现金
其他经营现金流	其他经营现金流
其他流动负债	其他流动负债
其他流动资产	其他流动资产
其他融资现金流	其他融资现金流
其他收益	其他收益
其他投资现金	其他投资现金
其他投资现金流	其他投资现金流
其他业务收入规模	其他业务收入规模
其他应付款	其他应付款
其他应收款	其他应收款
其他应收账款	其他应收账款
其他长期负债	其他长期负债
其他长期资产	其他长期资产
其他资产	其他资产
企业价值	企业价值
企业利润	企业利润
企业收入	企业收入
企业所得税率	企业所得税率
企业资产溢余收入	企业资产溢余收入
趋势回报率	趋势回报率
权益	权益比率	权益	权益报酬率	权益总额
权益乘数	权益乘数
权益性投资收益	权益性投资收益
让渡资产使用权收入	让渡资产使用权收入
人工成本	人工成本
日均成交值	日均成交值
融资现金流	融资现金流
融资现金流合计	融资现金流合计
融资现金流量	融资现金流量	融资性现金流量	融资活动现金流量	融资活动产生现金流量	融资活动净现金流量
三项费用	三项费用
少数股东权益	少数股东权益	少数股权
少数股东损益	少数股东损益
生息率	生息率
生息资产	生息资产
生息资产收益率	生息资产收益率
市净率	p/bv	市净率	p/b	pbr	pb
市销率	p/s	市销率	ps
市盈率	价格盈利指数	市价盈利比率	pe	per	p/e	股价收益比率	市盈率
市盈增长比率	市盈增长比率	peg
市值	市值
视同销售收入	视同销售收入
收购	收购
收盘价	收盘价
收入	收入
收入同比	营收同比	收入同比
收入增速	收入增长率	收入增速
收入占比	收入占比
收益	收益
收益倍数	moic	收益倍数
收益贡献率	收益贡献率
收益率	收益率	回报率
收益增长率	收益增长率
收益总额	收益总额
手续费及佣金收入	手续费及佣金收入
手续费净增速	手续费净增速
手续费收入净额	手续费收入净额
税后净利润	税后净利润
税后净利润率	税后净利润率
税后利润	税后利润
税后收益率	税后收益率
税金及附加	税金及附加
税前利润	计税利润	税前利润
税前利润率	税前利润率
税收	税收
税息折旧及摊销前利润	ebitda	税息折旧及摊销前利润
速动比率	速动资产与流动负债的比率	quick ratio	酸性测验比率	速动比率	acid-test ratio	速动比
所得税	所得税
所得税费用	所得税费用
所得税率	所得税率
所得税支出	所得税支出
所有者权益总额	所有者权益总额
摊销	摊销
特许权使用费收入	特许权使用费收入
提供劳务收入	提供劳务收入
贴现率	贴现率
同比增长	同比增长
同业负债	同业负债
同业资产	同业资产
投入成本	投入成本
投入资本	投入资本
投入资本回报率	投入资本回报率
投资	投资
投资变动	投资变动
投资回报率	投资回报率
投资回收期	投资回收期
投资活动现金	投资活动现金
投资活动现金流	投资活动现金流
投资价格	投资价格
投资价值	投资价值
投资决策	投资决策
投资评级	投资评级
投资收益	投资收益	投资净收益
投资收益率	投资收益率
投资损失	投资损失
投资现金净流入	投资现金净流入
投资现金流	投资现金流
投资现金流量	投资现金流量	投资活动现金流量
投资现金流量净额	投资现金流量净额	投资活动现金流量净额	投资活动净现金流量	投资活动产生的现金流量净额
投资性房地产	投资性房地产
投资性现金流	投资性现金流	投资活动现金净流
投资性现金流量	投资活动产生现金流量	投资性现金流量
投资占比	投资占比
外汇汇率	外汇汇率
违约金收入	违约金收入
未分配利润	未分配利润
无形资产	无形资产
息前税后利润	息前税后利润
息税前利润	ebit	息税前利润
现金	现金
现金本息债务比	现金本息债务比
现金比率	现金比率
现金储备	现金储备
现金股利支付	现金股利支付
现金股息	现金股息	现金股息支付比率
现金及现金等价物	现金及现金等价物
现金及现金等价物净增加额	现金及现金等价物净增加额
现金及现金等价物余额	现金及现金等价物余额
现金净流量	现金净流量
现金净流入	现金净流入
现金净增加额	现金净增加额	现金净变动
现金流出	现金流出	现金净流出
现金流出量	现金流出量
现金流净额	现金流净额
现金流净增加额	现金流净增加额
现金流量	现金流量
现金流量比率	经营现金流量比率	cash flow ratio	现金流量比率
现金流量表	现金流量表	现金流动表
现金流量充足率	现金流量充足率
现金流量对资本支出比率	现金流量对资本支出比率
现金流量回报率	现金流量回报率
现金流量净额	现金流量净额
现金流入	现金流入
现金流入量	现金流入量
现金流状况	现金流状况
现金收入	现金收入
现金收入比	现金收入比
现金余额	现金余额
现金占比	现金占比
现金支出	现金支出
现值	现值
限制性股票授予价格	限制性股票授予价格
销售成本	销售成本
销售成本率	销售成本率
销售额	销售额
销售费用	销售费用
销售费用率	销售费用率
销售货物收入	销售商品收入	销售货物收入
销售净利率	销售净利率
销售利润率	销售利润率
销售毛利率	销售毛利	销售毛利润	销售毛利率
销售收入	销售收入
销售收入增长率	销售收入增长率
销售增长率	销售增长率
信用减值损失	信用减值损失
行业基本面向好	行业基本面向好
研发费用	研发费用
研发费用率	研发费用率
研发费用占营业收入比例	研发费用占营业收入比例
研发占营收比重	研发占营收比重
研发支出	研发支出
业绩增长	业绩增长
业务及管理费	业务及管理费
业务收入	业务收入
一级资本充足率	一级资本充足率
应付票据	应付票据
应付票据及应付账款	应付票据及应付账款
应付债券	应付债券
应付账款	应付账款
应付账款及票据	应付账款及票据
应付账款周转率	应付账款周转率
应付账款周转天数	应付账款周转天数
应付职工薪酬	应付职工薪酬
应交税费	应交税费
应收款项	应收款项	应收账款
应收票据	应收票据
应收票据及应收账款	应收票据及应收账款
应收帐款周转率	应收帐款周转率
应收账款及票据	应收账款及票据
应收账款占比	应收账款占比
应收账款周转率	应收账款周转速度	应收账款周转率	收账比率
应收账款周转天数	应收账款周转天数
盈利能力	盈利能力
盈利收益比	盈利收益比
盈利预测	盈利预测
盈利预测表	盈利预测表
盈利预测每股净利润	盈利预测每股净利润
盈利增长	盈利增长率	盈利增长
盈余公积	盈余公积
盈余现金流	盈余现金流
营业成本	营业成本
营业费用	营业费用
营业费用率	营业费用率
营业利率	营业利率
营业利润	营业利润	销售利润
营业利润增长率	营业利润增长率	营业利润增长
营业利润占营业收入比率	营业利润占营业收入比率	营业利润率
营业收入	营收	营业额	营业收入
营业收入增速	营业收入增速
营业收入增长	营业收入增长
营业收入增长率	营收收入增长率	营收增长率	营业收入增长率
营业税金及附加	营业税金及附加
营业税金率	营业税金率
营业外收入	营业外收入
营业外收支	营业外收支
营业外支出	营业外支出
营业总成本	营业总成本
营业总收入	营业总收入
营运杠杆比率	营运杠杆比率
营运能力	营运能力
营运资本	营运资本	营运资金
营运资本周转率	营运资本周转率
营运资金变动	营运资金变动
营运资金的变化	营运资金的变化	营运资金的变动
有形资产净值	有形资产净值
预测净利润	预测净利润
预测利润率	预测利润率	预期利润
预测收入	预测收入
预付款项	预付款项
预付账款	预付账款
预留限制性股票数量	预留限制性股票数量
预期收入	预期收入
预收款项	预收款项
预收款占营业收入比例	预收款占营业收入比例
预收账款	预收账款
预收账款/当期新增合同额	预收账款/当期新增合同额
预收账款/合同负债	预收账款/合同负债
预收账款/营业收入	预收账款/营业收入
预收账款增长率	预收账款增长率
运输费用率	运输费用率
运营能力	运营能力
运营效率	运营效率
运营资本	运营资本	净运营资本	运营资本变动	运营资本周转率
运营资金	运营资金
在建工程	在建工程
增长率	增长率
债券	债券
债券收益率	债券收益率
债券投资	债券投资
债务比率	债务比率
债务服务覆盖率	债务服务覆盖率
负债股权比率	负债股权比率
债务利润率	债务利润率
债务募资	债务募资
债务收益率	债务收益率
债务与股本比率	债务与股本比率	债务股本比
债务重组收入	债务重组收入
债务资本比率	债务资本比率
长期偿债能力比率	长期偿债能力比率
长期负债	长期负债
长期负债比	长期负债比率	资本化比率	长期债务比率	长期负债比
长期负债合计	长期负债合计
长期股权投资	长期股权投资
长期借款	长期借款	长期贷款
长期借款比率	长期借款比率
长期借款及应付债券	长期借款及应付债券
长期投资	长期投资
长期债务	长期债务
长期债务与股东权益比率	长期债务与股东权益比率
长期资产	长期资产
长期资产总计	长期资产总计
账户余额	账户余额
账款总额	账款总额
账龄	账龄
账面价值	账面价值
账期	账期
折旧	折旧
折旧和摊销	折旧和摊销
折旧及摊销	折旧及摊销
折旧摊销	折旧摊销
支出	支出
支出率	支出率
直接或间接损失	直接或间接损失
主要财务比率	主要财务比率
主营业务成本	主营业务成本
主营业务收入	主营收入	主营业务收入
主营业务收入增长率	主营业务收入增长率	主营业务增长率
转让财产收入	转让财产收入
资本	资本
资本成本	资本成本
资本充足率	资本充足率
资本公积	资本公积
资本公积金	资本公积金
资本公积增加	资本公积增加
资本回报率	资本回报率	roic
资本结构	资本结构
资本金回报率	资本金回报率
资本利得	资本利得
资本利润率	资本利润率
资本收益率	资本收益率
资本占比	资本占比
资本支出	收益支出	资本支出	成本支出
资本支出/收入	资本支出/收入
资本周转率	资本周转率	股本周转率	投资周转率
资产	资产
资产报酬率	资产报酬率
资产处置收益	资产处置收益
资产负债表	资产负债表
资产负债率	资产负债比例	总负债率	负债比率	资产负债比率	举债经营比率	负债率	资产负债率
资产管理能力	资产管理能力
资产管理效率	资产管理效率
资产减值损失	资产减值损失
资产减值准备	资产减值准备
资产利润率	资产利润率
资产质量	资产质量
资产周转率	周转额/资产	资产与收入比	资产周转率
资产周转天数	资产周转天数
资产总额	期初资产总额	资产总额	期末资产总额
资产总计	资产总计	资产合计
资金回收期	资金回收期
资金利润率	资金利润率
资金流量表	资金流量表
自由现金流	fcf	自由现金流
自由现金流量	自由现金流量
自有资本	资本保留	自有资本
综合毛利率	综合毛利率
总市值	总市值
总债务率	总债务率	总债务比率
总资产净利率	资产净利率	总资产净利率	总资产净利润率
总资产利润率	总资产利润率
总资产收益率	总资产收益率	rota	资产回报率
租金收入	租金收入
总活期存款	总活期存款
总定期存款	总定期存款
总储蓄存款	总储蓄存款
综合损益表	综合损益表
综合融资成本	综合融资成本
综合费用率	综合费用率
自有物业投资额	自有物业投资额
自由流通市值	自由流通市值
自由流通股数	自由流通股数
自由流通股比例	自由流通股比例
自给率	自给率
资本金充足率	资本金充足率
资本滚动率	资本滚动率
价格价差	价格价差
证券买卖	证券买卖
证券经纪	证券经纪
证券交易费用	证券交易费用
招股书	招股书
长期负债率	长期负债率
债务水平	债务水平
债务率	债务率
债务利息覆盖倍数	债务利息覆盖倍数
债务净变化	债务净变化
债权人权益	债权人权益
债权募资	债权募资
预售额	预售额
永续增长率	永续增长率
销售税	销售税
相对折现率	相对折现率
相对涨幅	相对涨幅
相对收益	相对收益
外汇交易	外汇交易
外购煤价格	外购煤价格
外部收益率	外部收益率
外币兑换损益	外币兑换损益
吞吐量	吞吐量
退保金	退保金
投入资本收益率	投入资本收益率
速动资产比率	速动资产比率
赎回费率	赎回费率
手续费率	手续费率
市场基准	市场基准
市场回暖	市场回暖
生产配额	生产配额
申购费率	申购费率
商誉减值损失	商誉减值损失
商誉减值率	商誉减值率
商誉比率	商誉比率
派息率	派息率
派息比例	派息比例
流量表	流量表
流动资金比率	流动资金比率
留存公积	留存公积
利息率	利息率
库销比	库销比
扣预资产负债率	扣预资产负债率
扣非后净利润	扣非后净利润
可用资金	可用资金
可持续增长率	可持续增长率
可变成本	可变成本
静态投资回报率	静态投资回报率
静态收益率	静态收益率
静态市盈率	静态市盈率
静态负债率	静态负债率
静态比率	静态比率
借贷比率	借贷比率
价值比率	价值比率
价格走势	价格走势
汇兑损益	汇兑损益
合理市盈率	合理市盈率
股价收益率	股价收益率
杠杆率	杠杆率
负债资产率	负债资产率
负债占比	负债占比
存货成本率	存货成本率
纯利润	纯利润
储备利润	储备利润
财务盈余	财务盈余
财务杠杆	财务杠杆
财务负债	财务负债
财务风险	财务风险
财务分析	财务分析
保单红利支出	保单红利支出
财务风险控制	财务风险控制
财务杠杆关系	财务杠杆关系
财务杠杆系数	财务杠杆系数
财务自由度	财务自由度
纯利润率	纯利润率
大盘	大盘
发展支出	发展支出
付费率提升	付费率提升
付息倍数比率	付息倍数比率
估值中枢	估值中枢
股本管理	股本管理
股本回报	股本回报
股本利润率	股本利润率
股本资本公积	股本资本公积
股东红利分配	股东红利分配
股利支出	股利支出
股票总回报率	股票总回报率
汇兑收益	汇兑收益
季度净利润	季度净利润
季度营收	季度营业收入	季度营收
三费率	三费率
收付比	收付比
收益成长率	收益成长率
税负率	税负率
薪酬成本	薪酬成本
溢价率	溢价率
账目余额	账目余额
账务费用率	账务费用率
资本成本率	资本成本率
资本短缺	资本短缺
总现金流量	总现金流量
产销量	产销量
产销率	产销率
股份回购	股份回购
股份支付费用	股份支付费用
股利	股利
借款成本	借款成本
经济损失	经济损失
开盘价	开盘价
年产量	年产能	年产量
赔款支出	赔款支出
人均利润	人均利润
人均薪酬	人均薪酬
投融资金额	投融资金额
投融资情况	投融资情况
投融资数目	投融资数目
投融资总金额	投融资总金额
无息负债	无息负债
限制性股票摊销金额	限制性股票摊销金额
盈余杠杆	盈余杠杆
佣金率	佣金率
运营效率比率	运营效率比率
主营业务利润	主营业务利润
自由现金流量股息支付率	自由现金流量股息支付率
综合成本率	综合成本率
综合赔付率	综合赔付率
总产能	总产能
总资产报酬率	总资产报酬率
全部资产现金回收率	全部资产现金回收率
盈利现金比率	盈利现金比率
销售收现比率	销售收现比率
资产管理比率	资产管理比率
营业周期	营业周期
已获利息倍数	已获利息倍数
机会成本	机会成本
最佳现金持有量	最佳现金持有量
经济进货批量	经济进货批量
无筹资费率	无筹资费率
融资租赁	融资租赁
资本积累率	资本积累率
技术投入比率	技术投入比率
社会贡献率	社会贡献率
社会积累率	社会积累率
利润平均增长率	利润平均增长率
资本平均增长率	资本平均增长率
期初流动资产	期初流动资产
期末流动资产	期末流动资产
无形资产净值	无形资产净值
期初所有者权益合计	期初所有者权益合计
期末所有者权益合计	期末所有者权益合计
经营活动现金净流量	经营活动现金净流量
本期到期的债务	本期到期的债务
保费收入	保费收入
成本管控能力	成本管控能力
出口营业收入	出口营业收入
恶化贷款率	恶化贷款率
盈利比率	盈利比率
政府补助	政府补助
变动成本	变动成本
周转天数	周转天数
退税比例	退税比例
维管费	维管费
线上收入	线上收入
线上推广占比	线上推广占比
毛利	毛利	毛利润
经营活动产生现金流量	经营活动现金流	经营现金流	经营活动产生现金流量
投资活动产生现金流量	投资活动产生现金流量	投资现金流
融资活动产生现金流量	融资现金流	融资活动产生现金流量
现金的期初余额	现金的期初余额	期初净现金
现金的期末余额	现金的期末余额	期末净现金
roic	资本回报率	roic
复合年均增长率	复合增长率	复合年均增长率	cagr
三费	研发费用	销售费用	三费	管理费用
每股资本公积金	每股资本公积金
每股未分配利润	每股未分配利润
每股经营现金流	每股经营现金流
摊薄	摊薄
手续费及佣金净收入	手续费及佣金净收入
经纪业务手续费净收入	经纪业务手续费净收入
投资银行业务手续费净收入	投资银行业务手续费净收入
资产管理业务手续费净收入	资产管理业务手续费净收入
对联营企业和合营企业的投资收益	对联营企业和合营企业的投资收益
其他业务收入	其他业务收入
营业支出	营业支出
其他业务成本	其他业务成本
归属于母公司所有者的净利润	归属于母公司所有者的净利润
扣除经常性损益后的净利润	扣除经常性损益后的净利润
稀释每股收益	稀释每股收益
其他综合收益	其他综合收益
归属母公司所有者的其他综合收益	归属母公司所有者的其他综合收益
归属于少数股东的综合收益	归属于少数股东的综合收益
综合收益总额	综合收益总额
归属于母公司股东的综合收益总额	归属于母公司股东的综合收益总额
归属于少数股东的综合收益总额	归属于少数股东的综合收益总额
客户存款	客户存款
结算备付金	结算备付金
客户备付金	客户备付金
拆出资金	拆出资金
融出资金	融出资金
以公允价值计量且其变动计入当期损益的金融资产	以公允价值计量且其变动计入当期损益的金融资产
衍生金融资产	衍生金融资产
买入返售金融资产	买入返售金融资产
应收利息	应收利息
存出保证金	存出保证金
可供出售金融资产	可供出售金融资产
持有至到期投资	持有至到期投资
交易席位费	交易席位费
商誉	商誉
递延所得税资产	递延所得税资产
应付短期融资款	应付短期融资款
拆入资金	拆入资金
以公允价值计量且其变动计入当期损益的金融负债	以公允价值计量且其变动计入当期损益的金融负债
衍生金融负债	衍生金融负债
卖出回购金融资产款	卖出回购金融资产款
代理买卖证券款	代理买卖证券款
代理承销证券款	代理承销证券款
应付款项	应付款项
应付利息	应付利息
预计负债	预计负债
递延所得税负债	递延所得税负债
实收资本	实收资本
或股本	或股本
一般风险准备	一般风险准备
交易风险准备	交易风险准备
外币报表折算差额	外币报表折算差额
归属于母公司所有者权益合计	归属于母公司所有者权益合计
负债和所有者权益合计	负债和所有者权益合计
处置交易性金融资产净增加额	处置交易性金融资产净增加额
收取利息	收取利息
手续费及佣金的现金	手续费及佣金的现金
拆入资金净增加额	拆入资金净增加额
回购业务资金净增加额	回购业务资金净增加额
融出资金净减少额	融出资金净减少额
代理买卖证券收到的现金净额	代理买卖证券收到的现金净额
收到其他与经营活动有关的现金	收到其他与经营活动有关的现金
经营活动现金流入小计	经营活动现金流入小计
融出资金净增加额	融出资金净增加额
代理买卖证券支付的现金净额	代理买卖证券支付的现金净额
支付利息	支付利息
支付给职工以及为职工支付的现金	支付给职工以及为职工支付的现金
支付的各项税费	支付的各项税费
支付其他与经营活动有关的现金	支付其他与经营活动有关的现金
经营活动现金流出小计	经营活动现金流出小计
经营活动产生的现金流量净额	经营活动产生的现金流量净额
收回投资收到的现金	收回投资收到的现金
取得投资收益收到的现金	取得投资收益收到的现金
处置固定资产	处置固定资产
无形资产和其他长期资产收回的现金净额	无形资产和其他长期资产收回的现金净额
收到其他与投资活动有关的现金	收到其他与投资活动有关的现金
投资活动现金流入小计	投资活动现金流入小计
投资支付的现金	投资支付的现金
购建固定资产	购建固定资产
无形资产和其他长期资产支付的现金	无形资产和其他长期资产支付的现金
支付其他与投资活动有关的现金	支付其他与投资活动有关的现金
投资活动现金流出小计	投资活动现金流出小计
投资活动产生的现金流量净额	投资活动产生的现金流量净额
吸收投资收到的现金	吸收投资收到的现金
子公司吸收少数股东投资收到的现金	子公司吸收少数股东投资收到的现金
发行债券收到的现金	发行债券收到的现金
收到其他与筹资活动有关的现金	收到其他与筹资活动有关的现金
筹资活动现金流入小计	筹资活动现金流入小计
偿还债务支付的现金	偿还债务支付的现金
分配股利	分配股利
利润或偿付利息支付的现金	利润或偿付利息支付的现金
子公司支付给少数股东的股利	子公司支付给少数股东的股利
取得借款收到的现金	取得借款收到的现金
支付其他与筹资活动有关的现金	支付其他与筹资活动有关的现金
筹资活动现金流出小计	筹资活动现金流出小计
筹资活动产生的现金流量净额	筹资活动产生的现金流量净额
汇率变动对现金及现金等价物的影响	汇率变动对现金及现金等价物的影响
期初现金及现金等价物余额	期初现金及现金等价物余额
期末现金及现金等价物余额	期末现金及现金等价物余额
固定资产折旧	固定资产折旧
油气资产析耗	油气资产析耗
生产性生物资产折旧	生产性生物资产折旧
无形资产摊销	无形资产摊销
长期待摊费用摊销	长期待摊费用摊销
无形资产和其他长期资产的损失	无形资产和其他长期资产的损失
固定资产报废损失	固定资产报废损失
公允价值变动损失	公允价值变动损失
债务转为资本	债务转为资本
一年内到期的可转换公司债券	一年内到期的可转换公司债券
融资租入固定资产	融资租入固定资产
现金等价物的期末余额	现金等价物的期末余额
现金等价物的期初余额	现金等价物的期初余额
	
